Dnes=Heute
/den=/Tag
Co chcete letos zažít?=Was möchten Sie dieses Jahr erleben? 
Termín:=Termin:
Další lastminute= Weitere Last Minute 
Kč=CZK
Rezervace ubytování=Unterkunft Reservierung
Galerie=Galerie
Mapa=Stadtplan
Cena za osobu/týden=Preis pro Person/Woche
Cena za osobu/den=Preis pro Person/Tag
Termín=Termin
Ceník pro sezónu ZIMA=Preisliste Wintersaison
Ceník pro sezónu LÉTO=Preisliste Sommersaison
se snídaní=Mit Frühstück
Kč / den=CZK / Tag
Ceník=Preisliste
Provozovatel=Betreiber
Odkazy=Links
Jízdní řády=Fahrpläne
Webkamery=Webcams
Služby=SERVICE
Webkamery Harrachov=Webcams Harrachov
Mapa webu=Webseiteplan
Chata=Hütte
Napište hledaný výraz či objekt=Suche nach...
Zima=Wint
Léto=Somm
Zobrazit další=Mehr anzeigen
Více=Mehr
Popis=Beschreibung
Počasí=Wetter
Aktivity=Aktivitäten
Ski areál=Skiareal
Apartment=Apartment
Pension=Pension
Hledat na mapě=Auf dem Stadtplan suchen
Akce & události=Events & Veranstaltungen
Aktuality=News
Hotel=Hotel
Popis penzionu=Pension Beschreibung
Restaurace a bary=Restaurants und Bars
/page/cenik-reklamy=/page/Preisliste-Werbung
/page/skibus-harrachov=/page/Skibus-Harrachov
/live-kamera-harrachov=/live-camera-harrachov
Nekuřácké restaurace=Restaurants 
Restaurace v Harrachově=Restaurants in Harrachov
/lastminute=/Last Minute
Zítra=Morgen
/mapa=/Stadtplan
Webkamera Harrachov=Harrachov Webcam
/pocasi=/Wetter
Last minute=Last Minute
/akce=/Veranstaltungen
Slevové akce=Rabattaktionen
AKTIVIT=AKTIVITÄTEN
/aktuality=/News
Last Minute=Last Minute
/balicky=/pakete
Výhodné balíčky=Günstige Pakete
LAST MINUTE=LAST MINUTE
Live kamery=Live Webcams
počasí=Wetter 
/ubytovani/=/Unterkunft/
Chaty a chalupy=Ferienhäuser
/ubytovani/apartment=/Unterkunft/Apartment 
Aparmány=Apartments
To je vše=Das wäre alles
Cena již od=Preis bereits ab
/ubytovani/pension=/Unterkunft/Pension
 minut= Minuten
minuta=Minute
Pensiony=Pensionen
 minut= Minuten
/ubytovani=/Unterkunft
/ubytovani/hotel=/Unterkunft/Hotel
Hotely=Hotels
UBYTOVÁNÍ=UNTERKUNFT
/restaurace=/Restaurant
Restaurace=Restaurant
HARRACHOV=HARRACHOV
Ubytování=Unterkunft
Harrachov=Harrachov 
 minut= Minuten 
 minut= Minuten
 minut= Minuten
 minut= Minuten
 minut= Minuten
 minut= Minuten
 minut= Minuten
 minut= Minuten
Muzea=Museen
Lanovky a vleky=Seilbahnen und Lifte 
Aktivity (léto)=Aktivitäten (Sommer)
Tipy na výlety a zajímavá místa v okolí=Ausflugsziele und Sehenswürdigkeiten in der Umgebung
Když venku prší=Wenn es regnet
Směnárny=Wechselstuben
/sluzby=/Service
/aktivity=/Aktivitäten
/skiareal-harrachov=/Skiareal-Harrachov
/harrachov=/Harrachov
nyní= jetzt
od=ab
termín=Termin
Cena za apartmán/týden=Preis Apartment/Woche
bez stravy=ohne Verpflegung
Cena za apartmán/den=Preis Apartment/Tag
Více jak 5 dní=Ab 5 Tage
Cena za osobu=Preis pro Person
Lastminute, období mezi=Last Minute, Termin zwischen
celosezónní s určením data příjezdu=Saison lang mit Bestimmung des Anreisetermins
Cena/týden=Preis/Woche
Cena/den=Preis/Tag
last minute=Last Minute
Popis hotelu=Hotel Beschreibung
Vybavení pokojů=Zimmeraustattung
minuty=Minuten
Cena=Preis      
Sobota=Sontag
Pátek=Freitag 
Doporučujeme=Wir Empfehlen
Čtvrtek=Donnerstag
Středa=Mittwoch
Úterý=Dienstag
7 dní=7 Tage
Právě teď=Gerade jetzt
Celý přehled počasí=Wetter Im Detail
Přehled počasí=Wetter Vorschau
Facebook=Facebook
Slevy=Ermäßigungen
Neděle=Sonntag
On-Line Rezervace=Online-Buchung
LIVE KAMERY=LIVE CAMS
Příhlásit k odběru=Anmeldung
Chcete dostávat novinky přímo na Váš e-mail?=Wünschen Sie unsere Neuigkeiten per E-mail?
Administrace=Administration
Nepřehlédněte=Unsere Tipp
Odeslat=Senden
Všechny aktuality=Alle News
Pondělí=Montag
Najít ubytování=Unterkunft Suchen
Děti=Kinder
Osob=Personen
Odjezd=Abreise
Příjezd=Anreise
Typ objektu=Unterkunftskategorien
Kč /osoba=CZK /Person
Nový sníh=Neuschnee
Sníh celkem=Aktuelle Schneehöhen
48 h=48 St.
24 h=24 St.
Sněhové info=Schneebericht
Aktuální=Aktuelle
Proběhlé=Stattgefundene 
Akce v Harrachově=Events in Harrachov
Akce=Events
Infocentra=Infocenter  
Vybavení objektu=Vybavení objektu
lůžek=Betten  
Věk dítěte=Věk dítěte
Dětí=Kindern       
Webové aplikace: NETservis s.r.o.=Webové aplikace: NETservis s.r.o.
/hledat-na-mape=/im-stadtplan-finden
Detail=Detail 
pevná data bez volby příjezdu=pevná data bez volby příjezdu
Lyžařský balíček na víkend 8. - 10.1. 2016 se skipasem za 390,-Kč/Den=Lyžařský balíček na víkend 8. - 10.1. 2016 se skipasem za 390,-Kč/Den
Balíček=Balíček
Balíčky=Balíčky  
Slevy na Skipasy=Ermäßigung für die Skipässe
Co chcete zažít=Co chcete zažít  
Dospělí=Dospělí
DNES=DNES
Sportovní obchody=Sportovní obchody       
Kde=Kde