  
Dnes=Dziś
Co chcete letos zažít?=
Další lastminute=Kolejne lastminute
Chata=Domek
Apartment=Apartament
Pension=Pensjonat
Hotel=Hotel
Ceník=Cennik 
Provozovatel=Firma prowadząca
od=od
Odkazy=Linki
Termín:=Termin:
Jízdní řády=Rozkłady jazdy
Zítra=Jutro
Webkamery=Kamery Na Żywo
Služby=Usługi
Mapa webu=Mapa stron
/den=/dzień
Napište hledaný výraz či objekt=Wpisz szukany wyraz lub obiekt
Galerie=Galeria
Zima=Zima
od =od 
termín=termin
celosezónní s určením data příjezdu=całosezonowy ze wskazaniem daty przyjazdu
5 dnů RELAX & Wellness=5 dni RELAX & Wellness
Balíček=Pakiet
Balíčky=Pakiety
Rezervace ubytování=Rezerwacja noclegów
Mapa=Mapa
Léto=Lato
Cena za osobu/týden=Cena za osobę/tydzień
Webkamery Harrachov=Kamery Harrachov
/page/cenik-reklamy=/page/cennik-reklamy
/page/skibus-harrachov=/page/skibus-harrachov
/live-kamera-harrachov=/live-kamera-harrachov
Směnárny=Kantory
Muzea=Muzea
Sportovní obchody=Sklepy sportowe
Tipy na výlety a zajímavá místa v okolí=Propozycje wycieczek i ciekawe miejsca w okolicy
Turisticky zajímavá místa=Miejsca atrakcyjne turystycznie
Lyžařské školy a půjčovny lyží a snowboardů=Szkoły narciarskie i wypożyczalnie nart i snowboardów
Lanovky a vleky=Koleje linowe i wyciągi
/mapa=/mapa
Hledat na mapě=Szukaj na mapie
/pocasi=/pogoda
Počasí=Pogoda
Aktivity=Atrakcje
Ski areál=Ski Areal
/akce=/wydarzenie
Akce & události=Imprezy & wydarzenia
/aktuality=/aktualności
Aktuality=Aktualności
Zobrazit další=Pokaż kolejne
/lastminute=/lastminute
Last minute=Last minute
Last Minute=Last Minute
/balicky=/pakiety
Výhodné balíčky=Korzystne pakiety
/ubytovani/=/noclegi/
Chaty a chalupy=Domki i chaty
/ubytovani/apartment=/noclegi/apartament
Aparmány=Apartamenty
/ubytovani/pension=/noclegi/pensjonat
Pensiony=Pensjonaty
/sluzby=/usługi
Aktivity (zima)=Atrakcje (zima)
Aktivity (léto)=Atrakcje (lato)
Obchody=Sklepy
Infocentra=Informacje turystyczne
Restaurace a bary=Restauracje i bary
Privát=Kwatery prywatne
Chalupa=Chata
Otevřít detail=Pokaż szczegóły
/ubytovani/hotel=/noclegi/hotel
Hotely=Hotele
UBYTOVÁNÍ=NOCLEGI
/restaurace=/restauracje
Restaurace=Restauracje
HARRACHOV=HARRACHOV
/aktivity=/atrakcje
/skiareal-harrachov=/ośrodek narciarski-harrachov
Ubytování=Noclegi
/ubytovani=/Noclegi
Harrachov=Harrachov
/harrachov=/harrachov
Více=Więcej
Popis=Opis
Cena za osobu/den=Cena za osobę/dzień
Termín=Termin
Ceník pro sezónu ZIMA=Cennik na sezon ZIMA
Ceník pro sezónu LÉTO=Cennik na sezon LATO
Popis penzionu=Opis pensjonatu
minut=minut
se snídaní=ze śniadaniem
Cena za apartmán/týden=Cena za apartament/tydzień
bez stravy=bez wyżywienia
Cena za apartmán/den=Cena za apartament/dzień
Více jak 5 dní=Powyżej 5 dni
Cena za osobu=Cena za osobę
Lastminute, období mezi=Lastminute, okres między
nyní=teraz
Kč=CZK
Slevové akce=Promocje
To je vše=To wszystko
Cena již od=Cena już od
Vybavení pokojů=Wyposażenie pokojów
minuta=minuta
Vybavení objektu=Wyposażenie obiektu
minuty=minuty
Popis apartmánu=Opis apartamentu
Neděle=Niedziela
Sobota=Sobota
Pátek=Piątek
Čtvrtek=Czwartek
Středa=Środa
Právě teď=Właśnie teraz
Celý přehled počasí=Cała prognoza pogody
Přehled počasí=Prognoza pogody
Facebook=Facebook
Slevy=Zniżki
On-Line Rezervace=On-Line rezerwacja
LIVE KAMERY=LIVE KAMERY
Příhlásit k odběru=Zapisz się do odbioru
Chcete dostávat novinky přímo na Váš e-mail?=Chcesz otrzymywać informacje o aktualnościach bezpośrednio na e-mail?
Administrace=Administracja
Doporučujeme=Polecamy
LAST MINUTE=LAST MINUTE
Nepřehlédněte=Warto zobaczyć
Úterý=Wtorek
Všechny aktuality=Wszystkie aktualności
Pondělí=Poniedziałek
minut= minut
minut= minut
REZERVOVAT=ZAREZERWUJ
minut= minut
lůžek=miejsc
Najít ubytování=Znajdź nocleg
Děti=Dzieci
Osob=Osób
Odjezd=Wyjazd
Webkamera Harrachov=Kamera Harrachov
Příjezd=Przyjazd
Typ objektu=Typ obiektu
Kč /osoba=CZK /osoba
AKTIVIT=AKTIVIT
Live kamery=Live kamery
počasí=pogoda
7 dní=7 dni
Nový sníh=Nowy śnieg
Sníh celkem=Śnieg cały
48 h=48 h
24 h=24 h
Sněhové info=Sněhové info
Aktivity v Harrachově=Atrakcje w Harrachovie
Webové aplikace: NETservis s.r.o.=Webové aplikace: NETservis s.r.o.
Cena=Cena
Detail=Detail
pevná data bez volby příjezdu=pevná data bez volby příjezdu
Lyžařský balíček na víkend 8. - 10.1. 2016 se skipasem za 390,-Kč/Den=Lyžařský balíček na víkend 8. - 10.1. 2016 se skipasem za 390,-Kč/Den
Slevy na Skipasy=Zniżki na karnety 
/hledat-na-mape=/hledat-na-mape            
DNES=DNES  
Kč / den=Kč / den
Odeslat=Odeslat